Albedo	Geo	Ballad	"Wednesday, Saturday, Sunday"
Amber	Pyro	Freedom	"Monday, Thursday, Sunday"
Barbara	Hydro	Freedom	"Monday, Thursday, Sunday"
Beidou	Electro	Gold	"Wednesday, Saturday, Sunday"
Bennett	Pyro	Resistance	"Tuesday, Friday, Sunday"
Chongyun	Cryo	Diligence	"Tuesday, Friday, Sunday"
Diluc	Pyro	Resistance	"Tuesday, Friday, Sunday"
Diona	Cryo	Freedom	"Monday, Thursday, Sunday"
Eula	Cryo	Resistance	"Tuesday, Friday, Sunday"
Fischl	Electro	Ballad	"Wednesday, Saturday, Sunday"
Ganyu	Cryo	Diligence	"Tuesday, Friday, Sunday"
Hu Tao	Pyro	Diligence	"Tuesday, Friday, Sunday"
Jean	Anemo	Resistance	"Tuesday, Friday, Sunday"
Kaeya	Cryo	Ballad	"Wednesday, Saturday, Sunday"
Keqing	Electro	Prosperity	"Monday, Thursday, Sunday"
Klee	Pyro	Freedom	"Monday, Thursday, Sunday"
Lisa	Electro	Ballad	"Wednesday, Saturday, Sunday"
Mona	Hydro	Resistance	"Tuesday, Friday, Sunday"
Ningguang	Geo	Prosperity	"Monday, Thursday, Sunday"
Noelle	Geo	Resistance	"Tuesday, Friday, Sunday"
Qiqi	Cryo	Prosperity	"Monday, Thursday, Sunday"
Razor	Electro	Resistance	"Tuesday, Friday, Sunday"
Rosaria	Cryo	Ballad	"Wednesday, Saturday, Sunday"
Sucrose	Anemo	Freedom	"Monday, Thursday, Sunday"
Tartaglia	Hydro	Freedom	"Monday, Thursday, Sunday"
Traveler	Anemo Geo	ALL	"Sunday, Monday, Tuesday, Wednesday, Thursday, Friday, Saturday"
Venti	Anemo	Ballad	"Wednesday, Saturday, Sunday"
Xiangling	Pyro	Diligence	"Tuesday, Friday, Sunday"
Xiao	Anemo	Prosperity	"Monday, Thursday, Sunday"
Xingqiu	Hydro	Gold	"Wednesday, Saturday, Sunday"
Xinyan	Pyro	Gold	"Wednesday, Saturday, Sunday"
Yanfei	Pyro	Gold	"Wednesday, Saturday, Sunday"
Zhongli	Geo	Gold	"Wednesday, Saturday, Sunday"